/souko
/title DQ3‚Ìƒ}ƒbƒv
/start
0000000000000,
0000111110000,
0000133310000,
0000100010000,
0000100010000,
0111110111110,
0100400100010,
0101004040010,
0100011100010,
0111010101110,
0001010101000,
0001000001000,
0001002001000,
0001111111000,
0000000000000,
/end