/souko
/title ÇπÇ‹Å`Ç¢í òH
/start
0000000000000,
0111111111110,
0113111111110,
0130000004010,
0114111111010,
0112131131010,
0110111111010,
0110101101010,
0110110011010,
0110111111010,
0134400000010,
0113110110110,
0110000000110,
0111111111110,
0000000000000,
/end