/souko
/title TOUSAKU
/start
0000000000000,
0111111111110,
0111111111110,
0111111111110,
0111111111110,
0111003211110,
0111004431110,
0111113101110,
0111000001110,
0110040011110,
0110001111110,
0111111111110,
0111111111110,
0111111111110,
0000000000000,
/end